32 32
3  3  3  3  1  3  3  3  3  3  3  3  3  3  3  3  3  10 3  3  3  3  3  0  0  3  3  3  3  3  3  3  3  3  3  3
3  10 3  3  1  3  3  3  3  3  3  3  3  3  3  3  3  3  3  3  3  3  3  0  0  3  3  3  3  3  3  3  3  3  3  11
3  3  3  3  1  1  3  3  3  3  3  3  10 3  3  8  9  8  9  3  3  3  3  0  0  3  3  3  3  3  3  3  3  3  3  3
3  3  3  3  3  1  3  3  3  3  3  3  3  3  3  16 17 16 17 3  3  3  3  0  0  3  3  3  3  3  3  3  3  3  3  3
3  3  3  3  3  1  11 3  3  3  3  3  3  3  3  3  3  8  9  3  3  3  3  0  0  3  11 3  3  3  3  3  3  3  3  3
3  3  3  3  3  1  3  3  3  3  3  3  3  3  3  3  3  16 17 3  3  3  3  0  0  3  3  3  3  3  3  3  3  3  3  3
3  3  3  3  3  1  1  1  1  1  1  3  3  3  3  3  3  3  3  3  3  3  3  0  0  3  3  3  3  3  3  3  3  3  3  3
3  3  3  3  3  3  3  3  3  3  1  3  3  3  3  3  11 3  3  3  3  3  3  0  0  3  3  3  3  3  3  3  3  3  3  3
3  3  3  3  3  3  3  3  3  3  1  3  3  3  3  3  3  3  3  3  3  3  3  0  0  3  3  3  3  3  3  3  3  3  3  3
3  3  3  3  3  11 3  3  3  3  1  3  3  3  3  3  3  3  3  3  3  3  3  0  0  10 3  3  3  3  3  10 3  3  3  3
3  3  3  3  3  3  3  3  3  3  1  3  3  3  3  3  3  3  3  3  3  3  3  0  0  3  3  3  3  3  3  3  3  3  3  3
3  3  3  3  3  3  3  3  3  3  1  1  3  3  3  3  3  3  3  3  3  3  3  0  0  3  3  3  3  3  3  3  3  3  3  3
3  10 3  8  9  3  3  3  3  3  3  1  3  3  3  3  3  3  3  3  3  3  3  0  0  3  3  3  11 3  3  3  3  3  3  3
3  3  3  16 17 3  1  1  1  1  1  1  1  1  1  1  3  3  3  3  3  3  3  0  0  3  3  3  3  3  3  3  3  3  3  3
3  3  3  1  1  1  1  3  3  3  3  3  3  3  3  1  3  3  3  3  3  3  3  0  0  3  3  3  3  3  3  3  3  3  3  3
1  1  1  1  3  3  3  3  3  3  3  3  3  11 3  1  3  3  3  3  11 3  3  0  0  3  3  3  3  3  3  3  3  3  3  3
3  3  3  3  3  3  3  3  3  3  3  3  3  3  3  1  3  3  3  3  3  3  3  0  0  3  3  3  3  11 3  3  3  3  3  3
3  3  3  3  3  3  10 3  3  3  3  3  3  3  3  1  3  3  3  3  3  3  3  0  0  3  3  3  3  3  3  3  3  3  3  3
3  3  3  3  3  3  3  3  3  3  3  3  3  3  3  1  1  1  1  1  3  3  3  0  0  3  3  3  3  3  3  3  3  3  3  3
3  3  3  3  3  3  3  3  3  3  10 3  3  3  3  3  3  10 3  1  3  3  3  0  0  3  3  3  3  3  3  3  3  3  3  3
3  3  3  3  3  3  3  3  3  3  3  3  3  3  3  3  3  3  3  1  3  3  3  0  0  3  3  3  3  3  3  3  3  3  3  3
3  3  3  11 3  3  3  3  3  3  3  3  3  3  3  3  3  3  3  1  3  3  3  0  0  3  3  3  3  3  3  3  8  9  3  3
3  3  3  3  3  3  3  3  3  3  3  3  3  3  3  3  3  3  3  1  1  1  1  0  0  3  3  3  3  3  3  3  16 17 3  3
3  3  3  3  3  3  3  3  3  3  3  3  3  3  3  3  3  3  3  3  3  3  3  0  0  3  3  3  3  3  3  3  3  3  3  3
3  3  3  3  3  3  3  3  3  3  3  3  3  3  3  3  3  3  3  3  3  3  3  0  0  10 3  3  3  3  3  3  3  3  3  3
3  3  3  3  3  3  3  3  3  3  3  3  3  3  3  3  3  3  3  3  3  3  3  0  0  3  3  3  3  3  3  3  3  3  3  3
3  3  3  3  3  3  3  3  3  3  3  3  3  3  3  3  3  3  3  3  3  11 3  0  0  3  3  3  3  3  3  3  11 3  3  3
3  3  3  3  3  3  3  3  3  3  3  3  3  3  3  3  3  3  3  3  3  3  3  0  0  3  3  3  3  3  3  3  3  3  3  3
3  3  3  3  3  3  3  3  3  10 3  3  3  3  3  3  3  3  3  3  3  3  3  0  0  3  3  3  3  3  3  3  3  3  3  3
3  3  3  3  3  3  3  3  3  3  3  3  3  3  3  3  3  3  3  3  3  3  3  0  0  3  3  3  3  3  3  3  3  3  3  3