32 32
1  2  0  2  1  2  1  2  0  2  1  2  1  2  0  2  1  2  1  2  0  2  1  2  1  23 0  2  1  2  1  2  0  2  1  2
2  1  0  2  0  1  1  2  0  2  1  2  1  2  0  2  1  2  1  2  0  2  1  2  1  2  0  2  1  2  1  2  0  2  1  2
1  1  22 1  63 1  1  2  0  2  1  2  1  2  0  2  1  2  1  2  0  2  1  2  1  2  0  2  1  2  1  2  0  2  1  2
1  1  2  2  2  0  1  2  0  2  1  2  1  2  0  2  1  2  1  2  0  2  1  2  1  2  0  2  1  2  1  2  0  2  1  2
1  1  2  13 1  30 1  2  0  2  1  2  1  2  0  2  1  2  1  2  0  2  1  2  1  2  0  2  1  2  1  2  0  2  1  2
1  2  0  2  1  2  1  2  0  2  1  2  1  2  0  2  1  2  1  2  0  2  1  2  1  2  0  2  1  2  1  2  0  2  1  2
2  1  0  2  0  1  1  2  0  2  1  2  1  2  0  2  1  2  1  2  0  2  1  2  1  2  0  2  1  2  1  2  0  2  1  2
1  1  2  1  1  1  1  2  0  2  1  2  1  2  0  2  1  2  1  2  0  2  1  2  1  2  0  2  1  2  1  2  0  2  1  2
1  1  2  2  2  0  1  2  0  2  1  2  1  2  0  2  1  2  1  2  0  2  1  2  1  2  0  2  1  2  1  2  0  2  1  2
1  1  2  2  1  0  1  2  0  2  1  2  1  2  0  2  1  2  1  2  0  2  1  2  1  2  0  2  1  2  1  2  0  2  1  2
1  2  0  2  1  2  1  2  0  2  1  2  1  2  0  2  1  2  1  2  0  2  1  2  1  2  0  2  1  2  1  2  0  2  1  2
2  1  0  2  0  1  1  2  0  2  1  2  1  2  0  2  1  2  1  2  0  2  1  2  1  2  0  2  1  2  1  2  0  2  1  2
1  1  2  1  1  1  1  2  0  2  1  2  1  2  0  2  1  2  1  2  0  2  1  2  1  2  0  2  1  2  1  2  0  2  1  2
1  1  2  2  2  0  1  2  0  2  1  2  1  2  0  2  1  2  1  2  0  2  1  2  1  2  0  2  1  2  1  2  0  2  1  2
1  1  2  2  1  0  1  2  0  2  1  2  1  2  0  2  1  2  1  2  0  2  1  2  1  2  0  2  1  2  1  2  0  2  1  2
1  2  0  2  1  2  1  2  0  2  1  2  1  2  0  2  1  2  1  2  0  2  1  2  1  2  0  2  1  2  1  2  0  2  1  2
2  1  0  2  0  1  1  2  0  2  1  2  1  2  0  2  1  2  1  2  0  2  1  2  1  2  0  2  1  2  1  2  0  2  1  2
1  1  2  1  1  1  1  2  0  2  1  2  1  2  0  2  1  2  1  2  0  2  1  2  1  2  0  2  1  2  1  2  0  2  1  2
1  1  2  2  2  0  1  2  0  2  1  2  1  2  0  2  1  2  1  2  0  2  1  2  1  2  0  2  1  2  1  2  0  2  1  2
1  1  2  2  1  0  1  2  0  2  1  2  1  2  0  2  1  2  1  2  0  2  1  2  1  2  0  2  1  2  1  2  0  2  1  2
1  2  0  2  1  2  1  2  0  2  1  2  1  2  0  2  1  2  1  2  0  2  1  2  1  2  0  2  1  2  1  2  0  2  1  2
2  1  0  2  0  1  1  2  0  2  1  2  1  2  0  2  1  2  1  2  0  2  1  2  1  2  0  2  1  2  1  2  0  2  1  2
1  1  2  1  1  1  1  2  0  2  1  2  1  2  0  2  1  2  1  2  0  2  1  2  1  2  0  2  1  2  1  2  0  2  1  2
1  1  2  2  2  0  1  2  0  2  1  2  1  2  0  2  1  2  1  2  0  2  1  2  1  2  0  2  1  2  1  2  0  2  1  2
1  1  2  2  1  0  1  2  0  2  1  2  1  2  0  2  1  2  1  2  0  2  1  2  1  2  0  2  1  2  1  2  0  2  1  2
1  2  0  2  1  2  1  2  0  2  1  2  1  2  0  2  1  2  1  2  0  2  1  2  1  2  0  2  1  2  1  2  0  2  1  2
2  1  0  2  0  1  1  2  0  2  1  2  1  2  0  2  1  2  1  2  0  2  1  2  1  2  0  2  1  2  1  2  0  2  1  2
1  1  2  1  1  1  1  2  0  2  1  2  1  2  0  2  1  2  1  2  0  2  1  2  1  2  0  2  1  2  1  2  0  2  1  2
1  1  2  2  2  0  1  2  0  2  1  2  1  2  0  2  1  2  1  2  0  2  1  2  1  2  0  2  1  2  1  2  0  2  1  2
1  1  2  2  1  0  1  2  0  2  1  2  1  2  0  2  1  2  1  2  0  2  1  2  1  2  0  2  1  2  1  2  0  2  1  2